NO ./assets/north.xpm
SO ./assets/south.xpm
WE ./assets/west.xpm
EA ./assets/east.xpm

F 50,50,50
C 135,206,235

11111111111111111111
10000000000000000001
10000000000000000001
10001010101010101001
10000000000000000001
10000000000000001001
10000000000000001001
10000000000000001001
100000000000011C1001
10000000000000000001
10000000N00000000001
10000000000000000001
11111111111111111111
